###D#########
#......#....#
#......##.###
#.......?...#
#...........#
#...........#
#############