#######D############
#..................#
#..................#
#.....?............#
#..................#
#..................#
#..................#
#.......?..........#
#..................#
####################