###D###
#?....#
#....?#
#?....#
#??..?#
###?###